##########...####
#...#........#..#
##..........#####
#.......###..#..#
##..##....#.....#
#...##.........##
#........##....##
###............##
#######...#######